21-05-2021 17:18:19
Name: fff
ID: 342435263
Age: 54
Treated by: Dr.yinon21
Details:
Pregnant	Smoker	

Diagnose High Risk:
	Disorder of blood formation ---> Recommended Treatment:  10 mg pill of B12 per day for a month
5 mg pill of folic acid a day for a month.
	Kidney disease ---> Recommended Treatment: Balances blood sugar levels.

Diagnose Medium Risk:
	bleeding ---> Recommended Treatment: Evacuate urgently to the hospital.
	diet ---> Recommended Treatment: Schedule an appointment with a nutritionist.

Diagnose Low Risk:
	Infection ---> Recommended Treatment: Dedicated antibiotics.
	Viral disease ---> Recommended Treatment: Rest at home.
	Dehydration ---> Recommended Treatment: Complete lying down rest
returning fluids to drinking.
	Lung disease ---> Recommended Treatment: Stop Smoking / Referral for X-ray of the lungs.
	Increased consumption of meat ---> Recommended Treatment: Coordinate an appointment with a nutritionist.
	anemia ---> Recommended Treatment: Two 10 mg B12 pills a day for a month.
	Hyperlipidemia ---> Recommended Treatment: Arrange a meeting with a nutritionist 
	5 mg pill of Simobil daily for a week.
	cancer ---> Recommended Treatment: Entrectinib.
	heart diseases ---> Recommended Treatment: Schedule an appointment with a nutritionist.
	Adult diabetes ---> Recommended Treatment: Insulin adjustment for patient.
	Muscle diseases ---> Recommended Treatment: two 5 mg pills of Altman's c3 wrapper a day for a month.
	Smoker ---> Recommended Treatment: Quit smoking.
-------------------------------------------------------------------
